属性	属性描述
攻速	增加自身部队攻击速度
CD缩减	缩短技能施放后的间隔时间
移动速度	暂未开放
护甲值	增加部队物理防御
法术抗性	增加部队法术防御
基础格挡	对基础格挡值进行加成
攻击力	暂未开放
生命值	暂未开放
基础暴击	对基础暴击值进行加成
基础闪避	对基础闪避值进行加成
攻城攻击力	暂未开放
射程	增加攻击的射程范围
命中率	暂未开放
穿透	无视敌方部分物理防御
法术穿透	无视敌方部分法术防御
潜行	增加部队隐蔽能力使敌人无法发现自己
反潜行	增加部队的侦查能力，可以发现视野中存在的潜行敌人
视野	增加自身部队在地图中的可视范围
无视闪避	暂未开放
反弹物伤	受到物理伤害时反弹一定比例的伤害给攻击部队
反弹法伤	受到法术伤害时反弹一定比例的伤害给攻击部队
物理吸血	暂未开放
法术吸血	法术攻击时会回复一定比例的血量
暴击剑	暂未开放
溅射	暂未开放
物伤加深	暂未开放
法伤加深	暂未开放
