widget	script
Corps2_Chengchirenming	Corps2_Chengchirenming.cfg
Chengchirenming_Drag	ui_frame.cfg
Chengchirenming_Close	UI_Close.cfg
Chengchirenming_ListScroll	Chengchirenming_ListScroll.cfg
Chengchirenming_Renming1	Chengchirenming_Renming1.cfg
Chengchirenming_Renming2	Chengchirenming_Renming2.cfg
Chengchirenming_Renming3	Chengchirenming_Renming3.cfg
Chengchirenming_Renming4	Chengchirenming_Renming4.cfg
Chengchirenming_Renming5	Chengchirenming_Renming5.cfg
Chengchirenming_Renming6	Chengchirenming_Renming6.cfg
Chengchirenming_Renming7	Chengchirenming_Renming7.cfg
Chengchirenming_Renming8	Chengchirenming_Renming8.cfg
Chengchirenming_Renming9	Chengchirenming_Renming9.cfg
Chengchirenming_Renming10	Chengchirenming_Renming10.cfg
Chengchirenming_Mianchu1	Chengchirenming_Mianchu1.cfg
Chengchirenming_Mianchu2	Chengchirenming_Mianchu2.cfg
Chengchirenming_Mianchu3	Chengchirenming_Mianchu3.cfg
Chengchirenming_Mianchu4	Chengchirenming_Mianchu4.cfg
Chengchirenming_Mianchu5	Chengchirenming_Mianchu5.cfg
Chengchirenming_Mianchu6	Chengchirenming_Mianchu6.cfg
Chengchirenming_Mianchu7	Chengchirenming_Mianchu7.cfg
Chengchirenming_Mianchu8	Chengchirenming_Mianchu8.cfg
Chengchirenming_Mianchu9	Chengchirenming_Mianchu9.cfg
Chengchirenming_Mianchu10	Chengchirenming_Mianchu10.cfg
Chengchirenming_Tishi	Chengchirenming_Tishi.cfg
