widget	script
Newhuikui	UI_Newhuikui.cfg
UI_Close	UI_Close.cfg
UI_Huodong	UI_frame.cfg
UI_Bar	UI_Bar.cfg
Huodong_Name1	Huodong_Name1.cfg
Huodong_Name2	Huodong_Name2.cfg
Huodong_Name3	Huodong_Name3.cfg
Huodong_Name4	Huodong_Name4.cfg
Huodong_Name5	Huodong_Name5.cfg
Huodong_Name6	Huodong_Name6.cfg
Huodong_Name7	Huodong_Name7.cfg
Huodong_Name8	Huodong_Name8.cfg
Huodong_Name9	Huodong_Name9.cfg
Huodong_Name10	Huodong_Name10.cfg
UI_Ninjian1	UI_Ninjian1.cfg
UI_Ninjian2	UI_Ninjian2.cfg
UI_Ninjian3	UI_Ninjian3.cfg
UI_GoumaiCzhi1	UI_GoumaiCzhi1.cfg
UI_GoumaiCzhi2	UI_GoumaiCzhi2.cfg
UI_GoumaiCzhi3	UI_GoumaiCzhi3.cfg
Icon1	HuangZuanIcon.cfg
Icon2	HuangZuanIcon.cfg
Icon3	HuangZuanIcon.cfg
Icon4	HuangZuanIcon.cfg
Icon5	HuangZuanIcon.cfg
Icon6	HuangZuanIcon.cfg
Icon1_1	HuangZuanIcon.cfg
Icon2_1	HuangZuanIcon.cfg
Icon3_1	HuangZuanIcon.cfg
Icon4_1	HuangZuanIcon.cfg
Icon5_1	HuangZuanIcon.cfg
Icon6_1	HuangZuanIcon.cfg
Icon1_2	HuangZuanIcon.cfg
Icon2_2	HuangZuanIcon.cfg
Icon3_2	HuangZuanIcon.cfg
Icon4_2	HuangZuanIcon.cfg
Icon5_2	HuangZuanIcon.cfg
Icon6_2	HuangZuanIcon.cfg
UI_Dchongzhi	UI_ChongZhi.cfg
ShenQi_Chongzhi1	UI_ChongZhi.cfg
ShenQi_Chongzhi2	UI_ChongZhi.cfg
ShenQi_Chongzhi3	UI_ChongZhi.cfg
ShenQi_Chongzhi4	UI_ChongZhi.cfg
