widget	script
UI_Country1	UI_Country1.cfg
UI_Country1_Drag	UI_frame.cfg
UI_Country1_Close	UI_Close.cfg
UI_Country1_Label	CountryRadio.cfg
UI_Country2_ListScroll1	UI_Country_ListSroll1.cfg
UI_Country2_ListScrol2	UI_Country_ListSroll2.cfg
UI_Country3_Radio2	CountryRadio1.cfg
UI_Country2_EditNotice	UI_Country2_EditNotice.cfg
UI_Country2_PublishNotice	UI_Country2_PublishNotice.cfg
UI_BuildingType	UI_BuildingType.cfg
UI_Country3_Building	UI_Country_Build.cfg
UI_Country4_Select1	UI_Country_CheckBox.cfg
UI_Country4_Select2	UI_Country_CheckBox.cfg
UI_Country4_Select3	UI_Country_CheckBox.cfg
UI_Country4_Select4	UI_Country_CheckBox.cfg
UI_Country4_Select5	UI_Country_CheckBox.cfg
UI_Country4_Select6	UI_Country_CheckBox.cfg
UI_Country4_Select7	UI_Country_CheckBox.cfg
UI_Country4_Select8	UI_Country_CheckBox.cfg
UI_Country4_Select9	UI_Country_CheckBox.cfg
UI_Country4_Select10	UI_Country_CheckBox.cfg
UI_Country4_Select11	UI_Country_CheckBox.cfg
UI_Country4_Select12	UI_Country_CheckBox.cfg
UI_Country4_Select13	UI_Country_CheckBox.cfg
UI_Country4_Select14	UI_Country_CheckBox.cfg
UI_Country4_Select15	UI_Country_CheckBox.cfg
UI_Country4_Recommend	UI_Country4_Recommend.cfg
UI_Country5_StateList	UI_Country5_StateList.cfg
UI_Country5_Enfeoff	UI_Country5_Enfeoff.cfg
UI_Country5_ListScroll	UI_Country5_ListScroll.cfg
UI_Country5_Apply	UI_Country5_Apply.cfg
UI_Country8_Radio	CountryRadio3.cfg
UI_Country3_Store	UI_Country3_Store.cfg
UI_Country9_Sifting	UI_Country9_Sifting.cfg
UI_Country9_Queding	UI_Country9_Queding.cfg
UI_Country9_LeftPage	UI_Country9_LeftPage.cfg
UI_Country9_RightPage	UI_Country9_RightPage.cfg
UI_Country9_Query	UI_Country9_Query.cfg
UI_Country9_Select_1	UI_Country9_Select_1.cfg
UI_Country9_Select_2	UI_Country9_Select_2.cfg
UI_Country9_Select_3	UI_Country9_Select_3.cfg
UI_Country9_Select_4	UI_Country9_Select_4.cfg
UI_Country9_Select_5	UI_Country9_Select_5.cfg
UI_Country9_Select_6	UI_Country9_Select_6.cfg
UI_Country9_Select_7	UI_Country9_Select_7.cfg
UI_Country9_Select_8	UI_Country9_Select_8.cfg
UI_Country9_Select_9	UI_Country9_Select_9.cfg
UI_Country7_Fete	UI_Country7_Fete.cfg
UI_Country7_Worship	UI_Country7_Worship.cfg
UI_Country7_Economy	UI_Country7_Economy.cfg
UI_Country7_Function1	UI_Country7_Function1.cfg
UI_Country7_Function2	UI_Country7_Function2.cfg
UI_Country7_Function3	UI_Country7_Function3.cfg
UI_Crops6_2_Radio	UI_Crops6_2_Radio.cfg
UI_Country9_LevelMinimum	UI_Country9_LevelMinimum.cfg
UI_Country9_Max	UI_Country9_Max.cfg
UI_Country2_TopOfficials	UI_Country2_TopOfficials.cfg
UI_Country2_TopMilitaryOfficer	UI_Country2_TopMilitaryOfficer.cfg
UI_Country2_Chief	UI_Country2_Chief.cfg
UI_Country5_Cancel	UI_Country5_Cancel.cfg
UI_Country3_Jinger	UI_Country3_Jinger.cfg
UI_Country6_Select	UI_GuanzhiShop_Hit.cfg
UI_Country6_Radio1	UI_GuanzhiShop_Hit.cfg
UI_Buy1	UI_GuanzhiShop_Buy1.cfg
UI_Buy2	UI_GuanzhiShop_Buy2.cfg
UI_Buy3	UI_GuanzhiShop_Buy3.cfg
UI_Buy4	UI_GuanzhiShop_Buy4.cfg
UI_Buy5	UI_GuanzhiShop_Buy5.cfg
UI_Buy6	UI_GuanzhiShop_Buy6.cfg
UI_Buy7	UI_GuanzhiShop_Buy7.cfg
UI_Buy8	UI_GuanzhiShop_Buy8.cfg
UI_Buy9	UI_GuanzhiShop_Buy9.cfg
UI_Buy10	UI_GuanzhiShop_Buy10.cfg
UI_Buy11	UI_GuanzhiShop_Buy11.cfg
UI_Buy12	UI_GuanzhiShop_Buy12.cfg
GuojiaShop_ListScroll	GuojiaShop_ListScroll.cfg
IMG	HuangZuanIcon.cfg
IMG_1	HuangZuanIcon.cfg
IMG_2	HuangZuanIcon.cfg
IMG_3	HuangZuanIcon.cfg
IMG_4	HuangZuanIcon.cfg
IMG_5	HuangZuanIcon.cfg
IMG_6	HuangZuanIcon.cfg
IMG_7	HuangZuanIcon.cfg
IMG_8	HuangZuanIcon.cfg
IMG_9	HuangZuanIcon.cfg
IMG_10	HuangZuanIcon.cfg
IMG_11	HuangZuanIcon.cfg
