widget	script
UI_Gongfang	UI_GongfangCanvas.cfg
UI_Gongfang_Close	UI_Close.cfg
UI_Gongfang_Upgrade	UI_TerritoryBuilding_Upgrade.cfg
UI_Gongfang_Drag	UI_frame.cfg
UI_GongfangRaido	UI_GongfangRaido.cfg
GongFang_Raido3	GongFang_Raido3.cfg
UI_Gongfang_Bdzbdz_Reduce	UI_Gongfang_Bdzbdz_Reduce.cfg
UI_GongFang_Input17	UI_Gongfang_Bdzbdz_Input3.cfg
UI_Gongfang_Bdzbdz_Add	UI_Gongfang_Bdzbdz_Add.cfg
UI_Gongfang_Bdzbdz_Dz	UI_Gongfang_Bdzbdz_Dz.cfg
GongFang_Raido4	GongFang_Raido4.cfg
UI_Gongfang_Lzzbdz_Dz	UI_Gongfang_Lzzbdz_Dz.cfg
UI_Gongfang_Lzzbdz_Zbt	UI_Gongfang_Lzzbdz_Zbt.cfg
UI_GongFang_Up	UI_GongFang_Up.cfg
UI_GongFang_Down	UI_GongFang_Down.cfg
GongFangRaido2	GongFangRaido2.cfg
UI_Gongfang_Bdzbdz_Max	UI_Gongfang_Bdzbdz_Max.cfg
UI_GongFang_Icon1	UI_GongFangTips.cfg
UI_GongFang_Icon2	UI_GongFangTips.cfg
UI_GongFang_Icon3	UI_GongFangTips.cfg
UI_GongFang_Zbjl_Icon	UI_GongFang_Zbjl_Icon.cfg
UI_GongFang_Zbjl_Reserve	UI_GongFang_Zbjl_Reserve.cfg
UI_GongFang_Zbjl_Refine	UI_GongFang_Zbjl_Refine.cfg
UI_GongFang_Zbjl_Senior	UI_GongFang_Zbjl_Senior.cfg
UI_GongFang_Zbjl_Extreme	UI_GongFang_Zbjl_Extreme.cfg
GongFang_Raido5	GongFang_Raido5.cfg
UI_GongFang_Zbjl_Listctrl1	UI_GongFang_Zbjl_Listctrl1.cfg
UI_GongFang_Zbjl_Left	UI_GongFang_Zbjl_Left.cfg
UI_GongFang_Zbjl_Right	UI_GongFang_Zbjl_Right.cfg
UI_GongFang_Zbjl_Icon2	UI_GongFang_Zbjl_Icon2.cfg
UI_GongFang_Zbjl_Icon3	UI_GongFang_Zbjl_Icon3.cfg
UI_GongFang_Zbjl_Icon4	UI_GongFang_Zbjl_Icon4.cfg
UI_GongFang_Zbjl_Icon5	UI_GongFang_Zbjl_Icon5.cfg
UI_GongFang_Zbjl_Icon6	UI_GongFang_Zbjl_Icon6.cfg
GongFang_Raido6	GongFang_Raido6.cfg
UI_GongFang_Fl_Listctrl1	UI_GongFang_Zbjl_Listctrl1.cfg
UI_GongFang_Fl_Left	UI_GongFang_Zbjl_Left.cfg
UI_GongFang_Fl_Right	UI_GongFang_Zbjl_Right.cfg
UI_GongFang_Fl_Icon1	UI_GongFang_Fl_Icon1.cfg
UI_GongFang_Fl_Icon2	UI_GongFang_Fl_Icon2.cfg
UI_GongFang_Fl_Fl	UI_GongFang_Fl_Fl.cfg
UI_GongFang_Fl_Input3	UI_GongFang_Fl_Input3.cfg
UI_GongFang_Fl_Left2	UI_GongFang_Fl_Left2.cfg
UI_GongFang_Fl_Right2	UI_GongFang_Fl_Right2.cfg
UI_GongFang_Fl_Icon3	UI_GongFang_Zbjl_Icon2.cfg
UI_GongFang_Fl_Icon4	UI_GongFang_Zbjl_Icon3.cfg
UI_GongFang_Fl_Icon5	UI_GongFang_Zbjl_Icon4.cfg
UI_GongFang_Fl_Icon6	UI_GongFang_Zbjl_Icon5.cfg
UI_GongFang_Fl_Icon7	UI_GongFang_Zbjl_Icon6.cfg
GongFang_Raido7	GongFang_Raido7.cfg
UI_GongFang_Rl_Listctrl1	UI_GongFang_Rl_Listctrl1.cfg
UI_GongFang_Rl_Left	UI_GongFang_Rl_Left.cfg
UI_GongFang_Rl_Right	UI_GongFang_Rl_Right.cfg
UI_GongFang_Rl_Icon	UI_GongFang_Rl_Icon.cfg
UI_GongFang_Rl_fenjie	UI_GongFang_Rl_Common.cfg
UI_GongFang_Rl_rongjie	UI_GongFang_Rl_Common.cfg
UI_GongFang_Rl_shengji	UI_GongFang_Rl_Common.cfg
UI_GongFang_Rl_boli	UI_GongFang_Rl_boli.cfg
Reduce	UI_GongFang_Reduce.cfg
Add	UI_GongFang_Add.cfg
UI_GongFang_Rl_Input2	UI_GongFang_Rl_Input2.cfg
UI_GongFang_Add1	UI_GongFang_Add1.cfg
UI_GongFang_Add2	UI_GongFang_Add2.cfg
UI_GongFang_Add3	UI_GongFang_Add3.cfg
UI_Gongfang_Yjsm	UI_Yjsm.cfg
UI_GongFang_Zbjl_Input3	UI_GongFang_Zbjl_Input3.cfg
UI_GongFang_Zbjl_Input4	UI_GongFang_Zbjl_Input4.cfg
Bb_1_1	UI_GongFang_JunBei_Icon.cfg
Bb_2_1	UI_GongFang_JunBei_Icon.cfg
Bb_2_2	UI_GongFang_JunBei_Icon.cfg
Bb_2_3	UI_GongFang_JunBei_Icon.cfg
Bb_3_1	UI_GongFang_JunBei_Icon.cfg
Bb_3_2	UI_GongFang_JunBei_Icon.cfg
Bb_3_3	UI_GongFang_JunBei_Icon.cfg
Bb_4_1	UI_GongFang_JunBei_Icon.cfg
Bb_4_2	UI_GongFang_JunBei_Icon.cfg
Bb_4_3	UI_GongFang_JunBei_Icon.cfg
Bb_4_4	UI_GongFang_JunBei_Icon.cfg
Bb_4_5	UI_GongFang_JunBei_Icon.cfg
Bb_5_1	UI_GongFang_JunBei_Icon.cfg
Bb_5_2	UI_GongFang_JunBei_Icon.cfg
Bb_5_3	UI_GongFang_JunBei_Icon.cfg
Bb_5_4	UI_GongFang_JunBei_Icon.cfg
Bb_5_5	UI_GongFang_JunBei_Icon.cfg
Qb_ICON9	UI_GongFang_JunBei_Icon.cfg
Qb_ICON10	UI_GongFang_JunBei_Icon.cfg
Qb_ICON11	UI_GongFang_JunBei_Icon.cfg
Qb_ICON12	UI_GongFang_JunBei_Icon.cfg
Qb_ICON13	UI_GongFang_JunBei_Icon.cfg
Qb_ICON14	UI_GongFang_JunBei_Icon.cfg
Qb_ICON15	UI_GongFang_JunBei_Icon.cfg
Qb_ICON16	UI_GongFang_JunBei_Icon.cfg
Qb_ICON17	UI_GongFang_JunBei_Icon.cfg
Qb_ICON18	UI_GongFang_JunBei_Icon.cfg
Qb_ICON19	UI_GongFang_JunBei_Icon.cfg
Qb_ICON20	UI_GongFang_JunBei_Icon.cfg
Qb_ICON21	UI_GongFang_JunBei_Icon.cfg
Qb_ICON22	UI_GongFang_JunBei_Icon.cfg
Qb_ICON23	UI_GongFang_JunBei_Icon.cfg
Qb_ICON24	UI_GongFang_JunBei_Icon.cfg
Qx_ICON1	UI_GongFang_JunBei_Icon.cfg
Qx_ICON2	UI_GongFang_JunBei_Icon.cfg
Qx_ICON3	UI_GongFang_JunBei_Icon.cfg
Qx_ICON4	UI_GongFang_JunBei_Icon.cfg
Qx_ICON5	UI_GongFang_JunBei_Icon.cfg
Qx_ICON6	UI_GongFang_JunBei_Icon.cfg
Qx_ICON7	UI_GongFang_JunBei_Icon.cfg
Qx_ICON8	UI_GongFang_JunBei_Icon.cfg
Qx_ICON9	UI_GongFang_JunBei_Icon.cfg
Qx_ICON10	UI_GongFang_JunBei_Icon.cfg
Qx_ICON11	UI_GongFang_JunBei_Icon.cfg
Qx_ICON12	UI_GongFang_JunBei_Icon.cfg
Qx_ICON13	UI_GongFang_JunBei_Icon.cfg
Qx_ICON14	UI_GongFang_JunBei_Icon.cfg
Qx_ICON15	UI_GongFang_JunBei_Icon.cfg
Qx_ICON16	UI_GongFang_JunBei_Icon.cfg
Bb_Sign_1	UI_GongFang_JunBei_Upgrade.cfg
Bb_Sign_2	UI_GongFang_JunBei_Upgrade.cfg
Bb_Sign_3	UI_GongFang_JunBei_Upgrade.cfg
Bb_Sign_4	UI_GongFang_JunBei_Upgrade.cfg
Bb_Sign_5	UI_GongFang_JunBei_Upgrade.cfg
Bb_Sign_6	UI_GongFang_JunBei_Upgrade.cfg
Bb_Sign_7	UI_GongFang_JunBei_Upgrade.cfg
Bb_Sign_8	UI_GongFang_JunBei_Upgrade.cfg
Bb_Sign_9	UI_GongFang_JunBei_Upgrade.cfg
Bb_Sign_10	UI_GongFang_JunBei_Upgrade.cfg
Bb_Sign_11	UI_GongFang_JunBei_Upgrade.cfg
Bb_Sign_12	UI_GongFang_JunBei_Upgrade.cfg
Bb_Sign_13	UI_GongFang_JunBei_Upgrade.cfg
Bb_Sign_14	UI_GongFang_JunBei_Upgrade.cfg
Bb_Sign_15	UI_GongFang_JunBei_Upgrade.cfg
Bb_Sign_16	UI_GongFang_JunBei_Upgrade.cfg
Bb_Sign_17	UI_GongFang_JunBei_Upgrade.cfg
Qb_Upgrade1	UI_GongFang_JunBei_Upgrade.cfg
Qb_Upgrade2	UI_GongFang_JunBei_Upgrade.cfg
Qb_Upgrade3	UI_GongFang_JunBei_Upgrade.cfg
Qb_Upgrade4	UI_GongFang_JunBei_Upgrade.cfg
Qb_Upgrade5	UI_GongFang_JunBei_Upgrade.cfg
Qb_Upgrade6	UI_GongFang_JunBei_Upgrade.cfg
Qb_Upgrade7	UI_GongFang_JunBei_Upgrade.cfg
Qb_Upgrade8	UI_GongFang_JunBei_Upgrade.cfg
Qb_Upgrade9	UI_GongFang_JunBei_Upgrade.cfg
Qb_Upgrade10	UI_GongFang_JunBei_Upgrade.cfg
Qb_Upgrade11	UI_GongFang_JunBei_Upgrade.cfg
Qb_Upgrade12	UI_GongFang_JunBei_Upgrade.cfg
Qb_Upgrade13	UI_GongFang_JunBei_Upgrade.cfg
Qb_Upgrade14	UI_GongFang_JunBei_Upgrade.cfg
Qb_Upgrade15	UI_GongFang_JunBei_Upgrade.cfg
Qb_Upgrade16	UI_GongFang_JunBei_Upgrade.cfg
Qx_Upgrade1	UI_GongFang_JunBei_Upgrade.cfg
Qx_Upgrade2	UI_GongFang_JunBei_Upgrade.cfg
Qx_Upgrade3	UI_GongFang_JunBei_Upgrade.cfg
Qx_Upgrade4	UI_GongFang_JunBei_Upgrade.cfg
Qx_Upgrade5	UI_GongFang_JunBei_Upgrade.cfg
Qx_Upgrade6	UI_GongFang_JunBei_Upgrade.cfg
Qx_Upgrade7	UI_GongFang_JunBei_Upgrade.cfg
Qx_Upgrade8	UI_GongFang_JunBei_Upgrade.cfg
Qx_Upgrade9	UI_GongFang_JunBei_Upgrade.cfg
Qx_Upgrade10	UI_GongFang_JunBei_Upgrade.cfg
Qx_Upgrade11	UI_GongFang_JunBei_Upgrade.cfg
Qx_Upgrade12	UI_GongFang_JunBei_Upgrade.cfg
Bb_1_2	UI_GongFang_JunBei_BingzhongIcon.cfg
Bb_2_4	UI_GongFang_JunBei_BingzhongIcon.cfg
Bb_2_5	UI_GongFang_JunBei_BingzhongIcon.cfg
Bb_3_4	UI_GongFang_JunBei_BingzhongIcon.cfg
Bb_3_5	UI_GongFang_JunBei_BingzhongIcon.cfg
Bb_4_6	UI_GongFang_JunBei_BingzhongIcon.cfg
Bb_4_7	UI_GongFang_JunBei_BingzhongIcon.cfg
Bb_5_6	UI_GongFang_JunBei_BingzhongIcon.cfg
Bb_5_7	UI_GongFang_JunBei_BingzhongIcon.cfg
Qb_ICON1	UI_GongFang_JunBei_BingzhongIcon.cfg
Qb_ICON2	UI_GongFang_JunBei_BingzhongIcon.cfg
Qb_ICON3	UI_GongFang_JunBei_BingzhongIcon.cfg
Qb_ICON4	UI_GongFang_JunBei_BingzhongIcon.cfg
Qb_ICON5	UI_GongFang_JunBei_BingzhongIcon.cfg
Qb_ICON6	UI_GongFang_JunBei_BingzhongIcon.cfg
Qb_ICON7	UI_GongFang_JunBei_BingzhongIcon.cfg
Qb_ICON8	UI_GongFang_JunBei_BingzhongIcon.cfg
Qx_ICON13	UI_GongFang_JunBei_BingzhongIcon.cfg
Qx_ICON14	UI_GongFang_JunBei_BingzhongIcon.cfg
Qx_ICON15	UI_GongFang_JunBei_BingzhongIcon.cfg
Qx_ICON16	UI_GongFang_JunBei_BingzhongIcon.cfg
UI_GongFang_Zbjl_Lock_1	UI_GongFang_Zbjl_Lock_1.cfg
UI_GongFang_Zbjl_Lock_2	UI_GongFang_Zbjl_Lock_1.cfg
UI_GongFang_Zbjl_Lock_3	UI_GongFang_Zbjl_Lock_1.cfg
GongFang_Raido8	GongFang_Raido8.cfg
GongFang_Raido9	GongFang_Raido8.cfg
UI_Guizhe_Junbei	UI_guizejunbei.cfg
UI_Guizhe_Duanzao	UI_guizeduanzao.cfg
UI_GongFang_Zbjl_Refine2	UI_GongFang_Zbjl_Refine2.cfg
UI_GongFang_Zbjl_Xysx_1	UI_GongFang_Zbjl_shuxing.cfg
UI_GongFang_Zbjl_Xysx_2	UI_GongFang_Zbjl_shuxing.cfg
UI_GongFang_Zbjl_Xysx_3	UI_GongFang_Zbjl_shuxing.cfg
UI_GongFang_Zbjl_Xsx_1	UI_GongFang_Zbjl_shuxing.cfg
UI_GongFang_Zbjl_Xsx_2	UI_GongFang_Zbjl_shuxing.cfg
UI_GongFang_Zbjl_Xsx_3	UI_GongFang_Zbjl_shuxing.cfg
UI_GongFang_Zbjl_Refine3	UI_GongFang_Zbjl_Refine3.cfg
UI_Guizhe_JInglian	UI_Guizhe_JInglian.cfg
