Canvas	script
UI_GZPH	UI_GZPH.cfg
UI_Close	UI_Close.cfg
UI_Img	HuangZuanIcon.cfg
UI_Img_1	HuangZuanIcon.cfg
UI_Img_2	HuangZuanIcon.cfg
UI_Img_3	HuangZuanIcon.cfg
UI_Img_4	HuangZuanIcon.cfg
UI_Img_5	HuangZuanIcon.cfg
UI_Img_6	HuangZuanIcon.cfg
UI_Img_7	HuangZuanIcon.cfg
UI_Img_8	HuangZuanIcon.cfg
UI_Img_9	HuangZuanIcon.cfg
UI_Img_10	HuangZuanIcon.cfg
UI_Img_11	HuangZuanIcon.cfg
UI_Img_12	HuangZuanIcon.cfg
UI_Img_13	HuangZuanIcon.cfg
UI_Img_14	HuangZuanIcon.cfg
UI_Img_15	HuangZuanIcon.cfg
UI_Img_16	HuangZuanIcon.cfg
UI_Img_17	HuangZuanIcon.cfg
UI_Drag	ui_frame.cfg
UI_Guozhan_LingQu	UI_Guozhan_LingQu.cfg
UI_Guize	UI_Guize.cfg
GZpaihang_ListScroll	GZpaihang_ListScroll.cfg
