widget	script
ChengZhan	UI_Beta1_ChengZhan.cfg
ZaiXianLiBao	UI_ZaiXianLiBao.cfg
JingCaiHuoDong	UI_JingCaiHuoDong.cfg
GuanAiZhan	UI_Beta1_GuanAiZhan.cfg
UI_ManorStair_HuoDong	UI_ManorStair_HuoDong.cfg
Luntan	UI_Luntan.cfg
ZaiXianLiBao_Input	ZaiXianLiBao_Input.cfg
XiLian	XiLian.cfg
FuShui	FuShui.cfg
GuanZhi	UI_GuanZhi.cfg
LogReward	LogReward.cfg
Lunhui	Lunhui.cfg
HuoDong	HuoDong.cfg
XiaoGuanJia	XiaoGuanJia.cfg
Jianguo	Jianguo.cfg
UI_Qiridenglu	Qiridenglu.cfg
UI_Shouchong	Shouchong.cfg
UI_YueKa	YueKa.cfg
UI_ZiXuanLiBao	ZiXuanLiBao.cfg
UI_Chongzhihuikui	Chongzhihuikui.cfg
UI_Danbichongzhi	Danbichongzhi.cfg
UI_Xiaofeihuikui	Xiaofeihuikui.cfg
UI_Zhouka	Zhouka.cfg
UI_Zhengzhanshangdian	ZhengZhanShop.cfg
Hulaoguan	Hulaoguan.cfg
Houxuanren	Houxuanren.cfg
Guanyuanxuanju	Guanyuanxuanju.cfg
Toupiaojieguo	Toupiaojieguo.cfg
HuangZuan_Meirilibao	HuangZuan_Meirilibao.cfg
HuangZuan_Xinshoulibao	HuangZuan_Xinshoulibao.cfg
Panguo	UI_ManorStair_Panguo.cfg
Meirihaoli	Meirihaoli.cfg
UI_Youxibaodian	UI_manorIcon.cfg
Juntuan_Paiming	Juntuan_Paiming.cfg
