widget	script
UI_Show	UI_Show.cfg
Drag	UI_frame.cfg
Close	UI_Close.cfg
ArmyRaido	System_ArmyRaido.cfg
Blur	System_setRadio.cfg
DOF	System_setRadio.cfg
Shadow	System_setRadio.cfg
Use	System_Use.cfg
Pulldown1	System_setRadio.cfg
Pulldown2	System_setRadio.cfg
Pulldown3	System_setRadio.cfg
Pulldown4	System_setRadio.cfg
Pulldown5	System_setRadio.cfg
Pulldown6	System_setRadio.cfg
Input1	System_setRadio.cfg
Input2	System_setRadio.cfg
Input3	System_setRadio.cfg
Input4	System_setRadio.cfg
Input5	System_setRadio.cfg
Input6	System_setRadio.cfg
ShowRaido	System_ShowRaido.cfg
ShowRaido2	System_ArmyRaido.cfg
Pulldown9	System_Pulldown9.cfg
