widget	script
UI_StateEnfeoff	UI_StateEnfeoff.cfg
UI_StateEnfeoff_Title	UI_frame.cfg
UI_StateEnfeoff_Colse	UI_Close.cfg
UI_StateEnfeoff_Enfeoff1	UI_StateEnfeoff_Enfeoff1.cfg
UI_StateEnfeoff_Enfeoff2	UI_StateEnfeoff_Enfeoff2.cfg
UI_StateEnfeoff_Enfeoff3	UI_StateEnfeoff_Enfeoff3.cfg
UI_StateEnfeoff_Enfeoff4	UI_StateEnfeoff_Enfeoff4.cfg
UI_StateEnfeoff_Enfeoff5	UI_StateEnfeoff_Enfeoff5.cfg
UI_StateEnfeoff_Enfeoff6	UI_StateEnfeoff_Enfeoff6.cfg
UI_StateEnfeoff_Enfeoff7	UI_StateEnfeoff_Enfeoff7.cfg
UI_StateEnfeoff_Enfeoff8	UI_StateEnfeoff_Enfeoff8.cfg
UI_StateEnfeoff_Enfeoff9	UI_StateEnfeoff_Enfeoff9.cfg
UI_StateEnfeoff_Relieve1	UI_StateEnfeoff_Relieve1.cfg
UI_StateEnfeoff_Relieve2	UI_StateEnfeoff_Relieve2.cfg
UI_StateEnfeoff_Relieve3	UI_StateEnfeoff_Relieve3.cfg
UI_StateEnfeoff_Relieve4	UI_StateEnfeoff_Relieve4.cfg
UI_StateEnfeoff_Relieve5	UI_StateEnfeoff_Relieve5.cfg
UI_StateEnfeoff_Relieve6	UI_StateEnfeoff_Relieve6.cfg
UI_StateEnfeoff_Relieve7	UI_StateEnfeoff_Relieve7.cfg
UI_StateEnfeoff_Relieve8	UI_StateEnfeoff_Relieve8.cfg
UI_StateEnfeoff_Relieve9	UI_StateEnfeoff_Relieve9.cfg
UI_StateEnfeoff_Left	UI_StateEnfeoff_Left.cfg
UI_StateEnfeoff_Right	UI_StateEnfeoff_Right.cfg
