widget	script
UI_XLunhui	UI_LunhuiCanvas.cfg
UI_XLunhui_Drag	ui_frame.cfg
UI_XLunhui_Close	Ui_Close.cfg
XLunhui_Xz	UI_Lunhui_Radio.cfg
XLunhui_Cunchu	UI_LunHui_Button1.cfg
XLunhui_Cunchu_1	UI_LunHui_Button2.cfg
XLunhui_Quanbuquuchu1	UI_LunHui_Quchu.cfg
XLunhui_Quanbuquuchu2	UI_LunHui_Quchu.cfg
XLunhui_Quchu1	UI_LunHui_Quchu1.cfg
XLunhui_Quxiao	Ui_Close.cfg
XLunhui_Card1	detachcardforsave.cfg
XLunhui_Card2	detachcardforsave.cfg
XLunhui_Card3	detachcardforsave.cfg
XLunhui_Card4	detachcardforsave.cfg
XLunhui_Card5	detachcardforsave.cfg
XLunhui_Card6	detachcardforsave.cfg
XLunhui_Card7	detachcardforsave.cfg
XLunhui_Card8	detachcardforsave.cfg
XLunhui_Card9	detachcardforsave.cfg
XLunhui_Card10	detachcardforsave.cfg
XLunhui_Card11	detachcardforsave.cfg
XLunhui_Card12	detachcardforsave.cfg
XLunhui_Card13	detachcardforsave.cfg
XLunhui_Card14	detachcardforsave.cfg
XLunhui_Card15	detachcardforsave.cfg
XLunhui_Icon1	detachitemforsave.cfg
XLunhui_Icon2	detachitemforsave.cfg
XLunhui_Icon3	detachitemforsave.cfg
XLunhui_Icon4	detachitemforsave.cfg
XLunhui_Icon5	detachitemforsave.cfg
XLunhui_Icon6	detachitemforsave.cfg
XLunhui_Icon7	detachitemforsave.cfg
XLunhui_Icon8	detachitemforsave.cfg
XLunhui_Icon9	detachitemforsave.cfg
XLunhui_Icon10	detachitemforsave.cfg
XLunhui_Icon11	detachitemforsave.cfg
XLunhui_Icon12	detachitemforsave.cfg
XLunhui_Icon13	detachitemforsave.cfg
XLunhui_Icon14	detachitemforsave.cfg
XLunhui_Icon15	detachitemforsave.cfg
XLunhui_Icon16	detachitemforsave.cfg
XLunhui_Icon17	detachitemforsave.cfg
XLunhui_Icon18	detachitemforsave.cfg
XLunhui_Icon19	detachitemforsave.cfg
XLunhui_Icon20	detachitemforsave.cfg
