widget	script
UI_Youxibaodian	UI_Youxibaodian.cfg
Baodian_Drag	UI_frame.cfg
Baodian_Close	Baodian_Close.cfg
Baodian_Raido	Baodian_Raido.cfg
UI_Denzuo	UI_Denzuo.cfg
UI_Denyou	UI_Denyou.cfg
Linzhu	Linzhu.cfg
Zhuangbei	Zhuangbei.cfg
Keji	Keji.cfg
Jiangka	Jiangka.cfg
Guanzhi	Guanzhi.cfg
Bingzhong	Bingzhong.cfg
Zhankouli_close	Zhankouli_close.cfg
Guozhan_Zuo	Guozhan_Zuo.cfg
Guozhan_You	Guozhan_You.cfg
Neiroudi1	Neiroudi1.cfg
Neiroudi2	Neiroudi2.cfg
Neiroudi3	Neiroudi3.cfg
Neiroudi4	Neiroudi4.cfg
Neiroudi5	Neiroudi5.cfg
Neiroudi6	Neiroudi6.cfg
Neiroudi7	Neiroudi7.cfg
Neiroudi8	Neiroudi8.cfg
Neiroudi9	Neiroudi9.cfg
Neiroudi10	Neiroudi10.cfg
Neiroudi11	Neiroudi11.cfg
Neiroudi12	Neiroudi12.cfg
Neiroudi13	Neiroudi13.cfg
Neiroudi14	Neiroudi14.cfg
UI_Luntan	UI_Luntan.cfg
UI_Zuo_Dengjix	UI_Denzuo.cfg
UI_You_Dengjix	UI_Denyou.cfg
