widget	script
UI_ZhengzhanShop	UI_ZhengzhanShop.cfg
Drag	ui_frame.cfg
Close	UI_Close.cfg
ZhengzhanShop_ListScroll	UI_Country_ListSroll1.cfg
GuojiaShop_ListScroll_1	UI_Country_ListSroll1.cfg
Goumai1	UI_ZhengzhanShop_goumai.cfg
Goumai2	UI_ZhengzhanShop_goumai.cfg
Goumai3	UI_ZhengzhanShop_goumai.cfg
Goumai4	UI_ZhengzhanShop_goumai.cfg
Goumai5	UI_ZhengzhanShop_goumai.cfg
Goumai6	UI_ZhengzhanShop_goumai.cfg
Goumai7	UI_ZhengzhanShop_goumai.cfg
Goumai8	UI_ZhengzhanShop_goumai.cfg
Goumai9	UI_ZhengzhanShop_goumai.cfg
Goumai10	UI_ZhengzhanShop_goumai.cfg
Goumai11	UI_ZhengzhanShop_goumai.cfg
Goumai12	UI_ZhengzhanShop_goumai.cfg
Input25	zhanquantip.cfg
Icon1	ZhengZhanShop_Icon.cfg
Icon2	ZhengZhanShop_Icon.cfg
Icon3	ZhengZhanShop_Icon.cfg
Icon4	ZhengZhanShop_Icon.cfg
Icon5	ZhengZhanShop_Icon.cfg
Icon6	ZhengZhanShop_Icon.cfg
Icon7	ZhengZhanShop_Icon.cfg
Icon8	ZhengZhanShop_Icon.cfg
Icon9	ZhengZhanShop_Icon.cfg
Icon10	ZhengZhanShop_Icon.cfg
Icon11	ZhengZhanShop_Icon.cfg
Icon12	ZhengZhanShop_Icon.cfg
UI_Yuanbaoshuaxin	UI_Yuanbaoshuaxin.cfg
Goumai13	UI_goldgoumai.cfg
Goumai14	UI_goldgoumai.cfg
Goumai15	UI_goldgoumai.cfg
Goumai16	UI_goldgoumai.cfg
Goumai17	UI_goldgoumai.cfg
Goumai18	UI_goldgoumai.cfg
Goumai19	UI_goldgoumai.cfg
Goumai20	UI_goldgoumai.cfg
Goumai21	UI_goldgoumai.cfg
Goumai22	UI_goldgoumai.cfg
Goumai23	UI_goldgoumai.cfg
Goumai24	UI_goldgoumai.cfg
Icon13	goldshopicon.cfg
Icon14	goldshopicon.cfg
Icon15	goldshopicon.cfg
Icon16	goldshopicon.cfg
Icon17	goldshopicon.cfg
Icon18	goldshopicon.cfg
Icon19	goldshopicon.cfg
Icon20	goldshopicon.cfg
Icon21	goldshopicon.cfg
Icon22	goldshopicon.cfg
Icon23	goldshopicon.cfg
Icon24	goldshopicon.cfg
Goumai25	UI_blackgoumai.cfg
Goumai26	UI_blackgoumai.cfg
Goumai27	UI_blackgoumai.cfg
Goumai28	UI_blackgoumai.cfg
Goumai29	UI_blackgoumai.cfg
Icon25	blackshopicon.cfg
Icon26	blackshopicon.cfg
Icon27	blackshopicon.cfg
Icon28	blackshopicon.cfg
Icon29	blackshopicon.cfg
UI_Country6_Gxz3	Shuaxin.cfg
UI_Country1_shangdian	UI_Country1_shangdian.cfg
goumai1	UI_SuperEquipShop_goumai.cfg
goumai2	UI_SuperEquipShop_goumai.cfg
goumai3	UI_SuperEquipShop_goumai.cfg
goumai4	UI_SuperEquipShop_goumai.cfg
goumai5	UI_SuperEquipShop_goumai.cfg
goumai6	UI_SuperEquipShop_goumai.cfg
goumai7	UI_SuperEquipShop_goumai.cfg
goumai8	UI_SuperEquipShop_goumai.cfg
goumai9	UI_SuperEquipShop_goumai.cfg
goumai10	UI_SuperEquipShop_goumai.cfg
goumai11	UI_SuperEquipShop_goumai.cfg
goumai12	UI_SuperEquipShop_goumai.cfg
JiFen_jiangli1	ZhengZhanShop_Icon.cfg
JiFen_jiangli2	ZhengZhanShop_Icon.cfg
JiFen_jiangli3	ZhengZhanShop_Icon.cfg
JiFen_jiangli4	ZhengZhanShop_Icon.cfg
JiFen_jiangli5	ZhengZhanShop_Icon.cfg
JiFen_jiangli6	ZhengZhanShop_Icon.cfg
JiFen_jiangli7	ZhengZhanShop_Icon.cfg
JiFen_jiangli8	ZhengZhanShop_Icon.cfg
JiFen_jiangli9	ZhengZhanShop_Icon.cfg
JiFen_jiangli10	ZhengZhanShop_Icon.cfg
JiFen_jiangli11	ZhengZhanShop_Icon.cfg
JiFen_jiangli12	ZhengZhanShop_Icon.cfg
ShenQiShop_ListScroll	UI_Country_ListSroll1.cfg
